1111111111
100C0000E1
100CC1CC01
1PC00110C1
1111111111