1111111
1E0C011
1P0C0E1
1111111