1111111
1P0C0E1
1P0C001
1111111