1111111111
1T0C0000E1
100CC1CC01
1PC00110C1
1111111111