1111111111111111111111111111
1E0000000000000C00100C000001
1010010100100000101001010101
1010010010101010001001010101
1P0000000C00C0100000000000C1
1111111111111111111111111111